000000000000000000000000000
011111111111111111101111110
010000000000000000101111110
010000111001111000101111110
0111001010000011111P1111110
010100101000000000001111110
010100101111110000000111100
010100110000011111110011000
010100011000000000000000000
0101110011111F1111011100000
0100011F1110000001000100110
0-00011111111F1111k011111@0
000000000000000000000000000