000000000000000000000000000
011111111111111111100000000
010000000000000000100000000
010000111001111000100000000
011100101000001111100001110
010100101000000000000000010
010100101111110000000000010
010100110000011111110001010
010100011000000000010111010
010111001111111111011100010
010001111110000001000100110
0-0001111111111111k011111@0
000000000000000000000000000